 02 00 00 00 00 00 00 00 00 00 00 00 00 00 00 00 00 00 00 00 00 00 00 00 00 00 00 00 00 02
 02 00 00 00 00 00 00 00 00 00 00 00 00 00 00 00 00 00 00 00 00 00 00 00 00 00 00 00 00 02
 02 00 00 00 00 00 00 00 00 03 03 03 00 00 00 00 00 00 03 03 03 00 00 00 00 00 00 00 00 02
 02 00 00 00 00 00 00 00 00 03 04 03 00 00 00 00 00 00 03 04 03 00 00 00 00 00 00 00 00 02
 02 12 02 02 02 13 00 00 00 03 04 03 00 00 00 00 00 00 03 04 03 00 00 00 14 02 02 02 12 02
 02 11 02 02 02 02 02 02 02 02 02 02 10 10 10 10 10 10 02 02 02 02 02 02 02 02 02 02 11 02
 02 11 00 00 00 00 00 00 00 00 00 00 00 00 10 10 00 00 00 00 00 00 00 00 00 00 00 00 11 02
 02 11 00 00 00 00 00 00 00 00 00 00 00 00 10 10 00 00 00 00 00 00 00 00 00 00 00 00 11 02
 02 11 00 00 00 00 00 00 00 00 00 00 00 14 02 02 13 00 00 00 00 00 00 00 00 00 00 00 11 02
 02 11 00 00 00 00 00 00 00 00 00 00 14 02 02 02 02 13 00 00 00 00 00 00 00 00 00 00 11 02
 02 11 00 00 00 00 00 14 02 05 05 02 02 02 02 02 02 02 02 05 05 02 13 00 00 00 00 00 11 02
 02 02 13 00 00 10 10 02 02 02 02 02 02 02 02 02 02 02 02 02 02 02 02 10 10 00 00 14 02 02
 02 02 02 13 00 00 00 00 00 00 00 00 00 00 00 00 00 00 00 00 00 00 00 00 00 00 14 02 02 02
 02 02 02 02 13 00 00 00 00 00 00 00 00 00 00 00 00 00 00 00 00 00 00 00 00 14 02 02 02 02
 02 02 02 02 02 13 00 00 00 00 00 00 00 00 00 00 00 00 00 00 00 00 00 00 14 02 02 02 02 02
 02 02 02 02 02 02 12 02 00 00 00 00 00 00 02 02 00 00 00 00 00 00 02 12 02 02 02 02 02 02
 02 00 00 00 00 00 11 00 00 00 00 00 00 02 02 02 02 00 00 00 00 00 00 11 00 00 00 00 00 02
 02 00 00 00 00 00 11 00 00 00 00 00 02 02 02 02 02 02 00 00 00 00 00 11 00 00 00 00 00 02
 02 00 00 00 00 00 11 00 00 00 00 02 02 02 02 02 02 02 02 00 00 00 00 11 00 00 00 00 00 02
 02 00 00 00 00 00 11 00 00 00 10 03 03 03 04 03 03 03 03 10 00 00 00 11 00 00 00 00 00 02
 02 00 00 00 00 00 11 00 00 10 10 03 03 03 04 03 03 03 03 10 10 00 00 11 00 00 00 00 00 02
 02 05 05 02 02 02 02 02 02 02 02 02 12 02 02 02 02 12 02 02 02 02 02 02 02 02 02 05 05 02
 02 02 02 02 02 02 02 02 02 02 02 02 11 02 02 02 02 11 02 02 02 02 02 02 02 02 02 02 02 02
 02 00 00 00 00 00 00 00 00 00 00 00 11 00 00 00 00 11 00 00 00 00 00 00 00 00 00 00 00 02
 02 00 00 00 00 00 00 00 00 00 00 00 11 00 00 00 00 11 00 00 00 00 00 00 00 00 00 00 00 02
 02 03 03 03 00 00 00 00 00 00 00 00 11 00 00 00 00 11 00 00 00 00 00 00 00 00 03 03 03 02
 02 03 04 03 00 00 00 00 00 00 00 00 11 00 00 00 00 11 00 00 00 00 00 00 00 00 03 04 03 02
 02 03 04 03 00 00 00 00 00 00 00 00 11 00 00 00 00 11 00 00 00 00 00 00 00 00 03 04 03 02
 02 02 02 02 13 00 00 00 00 00 00 14 02 02 05 05 02 02 13 00 00 00 00 00 00 14 02 02 02 02
 02 02 02 02 02 02 02 02 02 02 02 02 02 02 02 02 02 02 02 02 02 02 02 02 02 02 02 02 02 02
